11111111111
10001E10001
10001010C01
10010001001
10000000001
10000000111
10CC0010001
10CC0010C01
100000100P1
11111111111