111111111111111
1C00000000001C1
111000111111101
100010000000001
101011101011111
101010001000001
101111101111101
1P00000M0100001
110111011101111
100000000100001
111110101101101
100010100100101
101010111110101
1C10000000101E1
111111111111111