111111111111111111111111111111111111
100000000000000000000000000000000001
100000000000000011111000111111111101
100000000000000111110000111110111101
100000000000001111100000111100111101
100000000000011111000000111000111101
100000000000111110000000110000111101
100000000001111100000000100000111101
100000000011111000000000000001111001
100000000111110000000000000011110001
100000001111100000000000000111100001
100000011111000000000000001111000001
100000111110000000000000011110000001
100000111111111111111000111100000101
100000111111111111111000111100001101
100000111111111111111000111100011101
100000111111111111111000111100111101
100000000000000011111000111101111101
100000000000000011111000111111111101
100000000000000011111000000000000001
100000000000000011111000000000000001
100000000000000011111000CE0000000001
100000000000000000CCC00CC00000000001
1000000PCCCCCCC00CC0C0CC000000000001
10000000000000CCCC00CCC0000000000001
111111111111111111111111111111111111