11111111111111111111
1CCCC1000000000000E1
10000100000000000001
10000100000100100101
1M0MM101100000000001
10000000000100100101
10000101100000000001
10000100000100100101
10000101100000000001
10000100000100100101
1MM0M101100000000001
10000100000100100101
10000101100000000001
11110100000100100101
1M0000000000000000M1
10011110010000000001
10010000010011111101
1001M011110100000101
1P010000C1000M10C1C1
11111111111111111111