1111111111
1000000001
1000P00P01
100000C001
1000C00001
1000000001
1000000001
1000000001
1000E00001
1111111111