1111111111
100000P001
10V0000001
1000000001
1000C00001
1000000001
1000000001
10000E0001
1000000001
1111111111