1111111111
1000000001
10000C0001
100C000001
100P000001
1000000001
1000000001
100E000001
1000000001
1111111111
