1111111111
1P10000001
1110000001
1000000001
1000000001
100000C001
1111100001
100000C001
1E00000001
1111111111