1111111111
1000000001
1000000001
1000C00001
100C000001
100000C001
1000000E01
1000000001
1000000001
1111111111