
1111111111
1000000001
100C000001
1000000001
1000000001
100C000001
100000P001
1000000001
100000E001
1111111111