1111111111
1000000001
1000000001
1000000P01

10000C0001
1000000001
1000C00001
1000000001
100000E001
1111111111