1111111111
1P00000001
1000000001
1C00C00001
1000000001
1000000001
1000C00001
10000E0001
10E0000001
1111111111