1111111111
1000000001
1000P00001
1000000001
1111111001
1000000001
10000E0001
1000000001
1000000001
1111111111